# $1, $2, $3
# $* = all arguments
# function ccn() {
# history | awk '{a[$2]++}END{for(i in a){print a[i] " " i}}' | sort -rn | head
# }

alias topc='top -o cpu'
alias topm='top -o vsize'

# git
alias gs='git status'
alias gl='git pull'
alias gp='git push'
alias gd='git diff | mate'
alias gc='git commit -v'
alias gca='git commit -v -a'
alias gb='git branch'
alias gba='git branch -a'
alias gco='git checkout'
alias gd='git diff'
alias gnp='git-notpushed'
alias ga='git add'

function gg() {
	git commit -v -a -m "$*"
}

# navigation
alias cdvph='cd ~/var/rails/vphthac'
alias cdjvp='cd ~/var/rails/jvphthac'
alias cdbun='cd ~/Library/Application\ Support/TextMate/Bundles/'

# aliases
alias reload="source ~/bin/dotfiles/bash/aliases"
alias ea='mate -w ~/bin/dotfiles/bash/aliases && reload'
alias ee='mate ~/bin/dotfiles/bash/env'
alias sas='alias | grep'
alias edhosts='mate /etc/hosts'

# logs
alias td='tail -f log/development.log'
alias tt='tail -f log/test.log'

# background jobs
alias stst='ruby script/starling_status'
alias wk='ruby script/workling_client '

# terminal
alias clr='clear'
alias lst='ls -lah'
alias lh='ls -al'
alias lt='ls -lt'
alias cdd="cd -"
alias his='history'
alias ff='ls -alR | grep '
alias fif='sudo grep -r '

# processes
alias tu='top -o cpu'
alias tm='top -o vsize'
alias psf='ps -ax | grep'

# Rails
alias ss='script/server'
alias sc='script/console'
alias sg='script/generate'
alias sp='script/plugin install'
alias sgm='script/generate migration'
alias rmig='rake db:migrate'
alias rsd='rake db:schema:dump'

alias gin="sudo gem install --no-ri --no-rdoc"
alias gist="gem list"
alias jgin="jruby -S gem install --no-rdoc --no-ri"
alias jgist="jruby -S gem list"
alias jss="jruby -S script/server"
alias jr="jruby -S"
alias jsc='jruby -S script/console'


alias rvl="rvm list rubies"
alias rvu="rvm use"
alias rvs="rvm $1 --symlink textmate"
alias rgin="rvm gem install --no-rdoc --no-ri"
alias rvsys="rvm use system; rvm rbx --symlink textmate"
alias rgi="sudo rake gems:install"
alias sro="rake routes | grep "
alias rvk="rvm list known"

function acuc {
  ./script/rstakeout "./script/cucumber" "app/**/*.rb" "features/**/*"
}

# RUBY
# use readline, completion and require rubygems by default for irb
alias irb='irb --simple-prompt -r irb/completion -rubygems'

# dump to fixtures, uses topfunky/ar_fixtures
alias tofix='rake db:fixtures:dump RAILS_ENV=development'

alias gll='gem list -l'
alias glr='gem list -r'
 
# really awesome function, use: cdgem <gem name>, cd's into your gems directory
# and opens gem that best matches the gem name provided
function cdgem {
  cd `gem env gemdir`/gems
  cd `ls | grep $1 | sort | tail -1`
}
function gemdoc {
  GEMDIR=`gem env gemdir`/doc
  open $GEMDIR/`ls $GEMDIR | grep $1 | sort | tail -1`/rdoc/index.html
}
function mategem {
  GEMDIR=`gem env gemdir`/gems
  mate $GEMDIR/`ls $GEMDIR | grep $1 | sort | tail -1`
 }

#  misc

# mojombo http://gist.github.com/180587
function pig {
  ps wwwaux | egrep "( $1 | %CPU )" | grep -v grep
}
